2 2 2 2 2 2 2 2 2 2 2 2 2 2 2 2 2 2 2 2 2 2 2 2
2 0 2 0 0 0 0 0 0 0 18 2 0 0 0 0 0 0 0 0 0 0 19 2
2 0 2 0 0 0 0 0 0 0 0 0 0 0 0 0 0 0 0 0 0 0 0 2
2 0 0 0 0 0 0 0 2 2 2 2 0 0 0 0 0 0 0 0 0 0 0 2
2 0 0 0 2 0 0 0 0 0 0 2 0 0 0 0 0 0 0 0 0 0 0 2
2 0 0 0 2 0 0 0 0 0 0 2 0 0 0 0 2 2 2 2 2 2 2 2
2 0 0 0 2 0 0 0 0 0 0 2 0 0 0 0 0 0 0 0 0 0 0 2
2 0 0 0 2 0 0 0 0 0 0 2 0 0 0 0 0 0 0 0 0 0 0 2
2 0 0 16 2 0 0 0 0 0 0 2 2 2 2 2 2 2 0 0 0 0 0 2
2 2 2 2 2 0 0 0 0 0 0 2 0 0 0 0 17 2 0 0 0 0 0 2
2 0 0 0 0 0 0 0 0 0 0 2 0 0 0 0 2 0 0 0 0 0 0 2
2 0 0 7 8 0 0 0 0 0 0 2 0 0 0 0 0 0 0 0 0 0 0 2
2 0 5 6 0 9 0 0 0 0 0 2 0 0 0 0 0 0 2 2 2 0 0 2
2 0 0 0 0 0 0 0 0 0 0 2 0 0 0 0 0 0 2 15 0 0 0 2
2 2 2 2 2 2 2 2 2 2 2 2 2 2 2 2 2 2 2 2 2 2 2 2