2 2 2 2 2 2 2 2 2 2 2 2 2 2 2 2 2 2 2 2 2 2 2 2
2 0 0 0 0 0 0 0 2 0 0 2 0 0 0 0 0 0 0 0 0 0 0 2
2 0 0 0 0 0 0 0 2 17 0 2 0 0 0 0 0 0 0 0 0 0 0 2
2 0 0 0 0 0 0 0 2 0 8 2 2 2 2 2 2 0 0 0 0 0 0 2
2 0 0 0 0 0 0 0 2 6 0 16 0 7 0 16 0 0 0 0 0 0 0 2
2 0 0 0 0 0 0 0 0 0 0 2 0 0 0 0 0 0 0 0 0 0 0 2
2 2 2 2 2 2 2 2 2 17 2 2 2 15 2 2 2 2 2 2 2 2 2 2
2 0 0 0 0 0 2 0 0 0 0 2 0 0 0 0 0 0 0 0 0 0 0 2
2 0 0 0 0 0 2 18 0 5 0 18 0 8 0 0 0 0 0 0 0 0 0 2
2 0 0 0 0 6 2 0 0 0 0 2 0 0 0 0 0 0 0 0 0 0 0 2
2 0 0 0 0 0 2 2 2 2 5 2 0 15 0 0 0 0 0 0 0 0 0 2
2 0 0 0 0 0 0 0 0 0 0 2 2 2 2 2 2 0 0 0 0 0 0 2
2 0 0 0 0 0 0 0 0 0 0 0 0 0 0 0 7 0 0 0 0 0 0 2
2 0 0 0 0 0 0 0 0 0 0 2 0 0 0 0 0 0 0 0 0 0 0 2
2 2 2 2 2 2 2 2 2 2 2 2 2 2 2 2 2 2 2 2 2 2 2 2