2 2 2 2 2 2 2 2 2 2 2 2 2 2 2 2 2 2 2 2 2 2 2 2
2 0 0 0 0 0 0 0 0 0 0 0 0 0 0 0 0 0 0 0 0 0 0 2
2 0 5 6 0 0 0 0 0 0 0 8 0 0 0 0 0 0 0 0 0 7 0 2
2 0 0 0 0 0 0 0 0 0 0 0 0 0 0 0 7 0 0 0 0 0 0 2
2 0 0 0 0 8 0 0 0 0 0 0 5 0 0 0 0 0 0 6 0 0 0 2
2 0 0 7 0 0 0 0 0 0 0 0 0 0 0 0 0 0 0 0 0 0 0 2
2 0 0 0 0 0 0 0 0 0 0 0 0 0 0 0 0 0 0 0 0 0 0 2
2 0 0 0 0 0 0 0 0 0 2 2 2 2 0 0 0 0 0 0 0 0 0 2
2 0 0 0 7 0 0 0 0 0 15 17 16 18 0 0 0 8 0 0 0 0 0 2
2 0 0 0 0 6 0 2 0 0 17 16 15 15 0 0 0 0 0 0 0 5 0 2
2 0 0 0 0 0 0 2 0 0 16 17 18 15 2 0 0 0 0 0 0 0 0 2
2 0 5 8 0 0 0 2 0 0 18 16 17 18 2 0 0 0 0 0 0 0 0 2
2 0 0 0 0 0 0 2 0 0 0 0 0 0 0 0 0 0 0 0 6 0 0 2
2 0 0 0 0 0 0 0 0 0 0 0 0 0 0 0 0 0 0 0 0 0 0 2
2 2 2 2 2 2 2 2 2 2 2 2 2 2 2 2 2 2 2 2 2 2 2 2