2 2 2 2 2 2 2 2 2 2 2 2 2 2 2 2 2 2 2 2 2 2 2 2
2 0 0 0 0 0 0 0 15 16 17 18 19 15 16 2 0 0 0 0 0 0 0 2
2 0 0 0 0 0 0 2 0 0 0 0 0 0 0 0 2 0 0 0 0 0 0 2
2 0 0 0 0 0 0 2 0 0 0 2 0 0 0 0 0 2 0 0 0 0 0 2
2 0 0 0 0 0 0 2 0 0 0 0 6 0 0 5 0 2 0 0 0 0 0 2
2 0 0 0 0 0 0 2 0 0 9 0 5 0 0 0 2 0 0 0 0 0 0 2
2 0 0 0 0 0 0 2 0 0 7 0 2 0 0 2 0 0 0 0 0 0 0 2
2 0 0 0 0 0 2 0 0 0 2 0 2 0 0 0 2 0 0 0 0 0 0 2
2 0 0 0 0 2 0 0 0 0 2 0 9 0 0 0 0 2 0 0 0 0 0 2
2 0 0 0 2 0 0 0 0 0 7 0 8 0 0 0 0 0 2 0 0 0 0 2
2 0 0 0 2 0 0 0 0 0 5 0 6 0 0 0 0 0 2 0 0 0 0 2
2 0 0 0 2 0 0 0 0 0 6 2 8 0 0 0 0 0 2 0 0 0 0 2
2 0 0 0 0 2 2 0 0 0 0 0 0 0 0 0 2 2 0 0 0 0 0 2
2 0 0 0 0 0 0 2 2 17 18 19 15 16 2 2 0 0 0 0 0 0 0 2
2 2 2 2 2 2 2 2 2 2 2 2 2 2 2 2 2 2 2 2 2 2 2 2